1111111111
1000010001
1002000001
1020020001
1000000001
1002000001
1000000001
1000010001
1320000031
1111111111
