1111111111
1302222031
1022222201
1222002221
1222002221
1222002221
1222002221
1022222201
1002222001
1111111111
