1111111111
1002112001
1022112201
1220220221
1122002211
1122002211
1220220221
1022112201
1302112031
1111111111
